+-+-+-+-+-+
|G        |
+ +-+-+ + +
|     |   |
+ +-+ +-+ +
|   | |   |
+ +-+ + +-+
| |   | | |
+ + +-+ + +
| |   |  S|
+-+-+-+-+-+