+-+-+-+-+-+-+-+-+
|G          |   |
+ + + +-+-+ +-+ +
| | | |         |
+ + + +-+-+ +-+-+
|   |   |       |
+ + + + + +-+-+ +
| |   |   |   | |
+ +-+ +-+-+ + + +
|     |     | | |
+ +-+ +-+-+-+ + +
|             | |
+-+ +-+-+ + +-+ +
|         |   | |
+ + +-+ +-+ + + +
|     |     |  S|
+-+-+-+-+-+-+-+-+