+-+-+-+-+
|S      |
+ +-+-+ +
|       |
+ + + + +
|   | | |
+ +-+ + +
|      G|
+-+-+-+-+