+-+-+-+-+-+-+-+-+-+-+-+-+-+-+-+
|S    |       |         |     |
+ + + +-+ + + +-+ + +-+-+ +-+ +
|   |     | |       |       | |
+ + + +-+ + +-+ +-+ + +-+-+-+ +
| |   |   |   |         |     |
+-+-+ + + +-+ +-+ +-+ +-+ +-+ +
|     |                       |
+ +-+ +-+-+-+-+ +-+-+-+ +-+-+-+
|   | |     |           |     |
+ + + + +-+ +-+-+ +-+ +-+ +-+ +
|   |   |       |         | | |
+-+ +-+ + +-+-+ + +-+-+-+-+ + +
|   |   |     |   | |       | |
+ +-+ + + + +-+ +-+ + + + + +-+
| |   |   |       |   |   |   |
+ + +-+ + + + +-+-+ +-+-+-+-+ +
|       |   |           |     |
+ +-+ + + + + + +-+-+-+ + +-+ +
|           | |     |     |   |
+ +-+ +-+-+ +-+ +-+ + +-+ + + +
| |       |   |   |   |       |
+ +-+ +-+ +-+ + + + + + +-+ + +
|     |   | |   |     |   | | |
+ + + + + + +-+ + +-+-+-+ + + +
|   |           |         |   |
+ + +-+ +-+ +-+-+ + +-+-+-+-+ +
| |   |   | |     | |   |   | |
+ +-+ +-+ + + +-+ + + + + + + +
|                     |   |  G|
+-+-+-+-+-+-+-+-+-+-+-+-+-+-+-+