+-+-+-+-+-+-+-+-+-+
|S                |
+ + +-+-+-+ +-+-+ +
| |           |   |
+ +-+-+ + + + +-+-+
| |   |   | |     |
+ + + +-+-+ +-+-+ +
|   | |   | |     |
+-+ + + + + + + + +
|       |   |   | |
+ +-+ +-+-+-+-+ + +
|   | |         | |
+ + + + + +-+-+-+ +
| | |   | |   | | |
+ + + + + +-+ + + +
|   | | |   | |   |
+ +-+ + + +-+ + +-+
|     |          G|
+-+-+-+-+-+-+-+-+-+