+-+-+-+-+-+-+-+
|S            |
+ +-+ +-+-+ + +
|     |     | |
+ + +-+ +-+ + +
|     | |   | |
+ +-+ + +-+ + +
|   |     |   |
+-+ +-+ + + + +
|   |   |     |
+ + + +-+ +-+ +
| |     |   | |
+ + +-+ +-+ + +
|           |G|
+-+-+-+-+-+-+-+