+-+-+-+-+-+-+-+-+
|G          |   |
+ + + +-+-+ +-+ +
| | | |         |
+ + + +-+-+-+-+ +
| | |   |       |
+ + + + + +-+-+ +
| |   |   |   | |
+ +-+ +-+-+ + + +
|     |     | | |
+ +-+ + +-+-+ + +
|             | |
+-+ +-+-+ + +-+ +
|         |   | |
+ + +-+ +-+ + + +
|     |     |  S|
+-+-+-+-+-+-+-+-+