+-+-+-+-+-+-+
|S  |       |
+ + + +-+ + +
|       |   |
+ +-+-+ + +-+
|     |   | |
+-+ + +-+-+ +
|           |
+ +-+ + +-+ +
|   |   |   |
+-+ + + + +-+
|          G|
+-+-+-+-+-+-+