+-+-+-+-+-+-+
|S  |       |
+ + + +-+ + +
|       |   |
+ +-+-+ + + +
|     |   | |
+-+ + +-+ + +
|           |
+ +-+ + +-+ +
|   |   |   |
+-+ + + + +-+
|          G|
+-+-+-+-+-+-+