+-+-+-+-+-+
|G    |   |
+ +-+ + + +
|         |
+ +-+ +-+ +
|   | |   |
+ +-+ + + +
| |     | |
+ + +-+ + +
|        S|
+-+-+-+-+-+